5
6
6 6 6 6 6
6 1 1 1 6
6 1 2 1 6
6 1 0 1 6
6 1 1 1 6
6 6 6 6 6