11
11
1 1 1 1 1 1 1 1 1 1 1
1 0 0 0 0 3 0 0 0 0 1
1 0 0 0 1 1 0 0 0 0 1
1 2 1 0 0 0 0 0 0 1 1
1 0 0 0 0 0 0 0 0 0 1
1 0 0 0 0 1 0 1 0 0 1
1 0 1 0 0 0 0 0 1 4 1
1 0 0 1 0 0 0 0 0 0 1
1 0 0 0 1 0 1 0 1 0 1
1 0 0 0 5 0 0 0 0 0 1
1 1 1 1 1 1 1 1 1 1 1
4
6 4 5
7 5 4
8 6 5
9 5 6