5
9
1 1 1 1 1
1 0 3 0 1
1 2 1 4 1
1 0 5 0 1
1 0 1 0 1
1 0 0 0 1
1 0 1 0 1
1 0 0 0 1
1 1 1 1 1
4
6 1 6
7 2 5
8 3 6
9 2 7