5
7
1 1 1 1 1
1 2 1 0 1
1 5 1 0 1
1 0 10 0 1
1 0 1 3 1
1 0 1 4 1
1 1 1 1 1
4
6 1 5
7 1 4
8 3 1
9 3 2