7
7
1 1 1 1 1 1 1
1 1 1 0 2 1 1
1 5 0 0 0 1 1
1 1 0 1 0 0 1
1 1 0 0 0 3 1
1 1 4 0 0 1 1
1 1 1 1 1 1 1
4
6 4 5
7 3 5
8 3 1
9 5 3