7
7
1 1 1 1 1 1 1
1 2 1 1 1 0 1
1 5 1 1 0 0 1
1 0 1 1 1 3 1
1 0 0 1 1 4 1
1 0 0 1 0 0 1
1 1 1 1 1 1 1
4
6 2 5
7 4 5
8 4 2
9 2 4