9
9
1 1 1 1 1 1 1 1 1
1 0 0 1 1 0 3 0 1
1 2 1 0 0 0 1 0 1
1 0 0 0 1 0 1 0 1
1 1 0 0 1 0 0 1 1
1 0 0 0 0 1 0 0 1
1 0 1 0 0 0 1 4 1
1 0 5 0 1 0 0 0 1
1 1 1 1 1 1 1 1 1
4
6 6 4
7 4 6
8 2 4
9 4 2